*************************************************************************************
*                                                            (~|_  _  _  _  _  _  _ *
*                                                            _)| |(_)|_)(/_(/_(/_(/_*
*                                                                    |              *
*                  Please Write your feedback in the space below                    *
*                  (Maximum length is 200 characters, including spaces):            *
*                                                                                   *
*************************************************************************************
